1, 1, 1, 1, 1, 1, 1,
1, 0, 0, 0, 0, 0, 1,
1, 0, x, x, a, 3, 1,
1, 0, 0, 0, z, 0, 1,
1, 0, 0, 0, 1, 1, 0, 3, 1,
1, v, a, l, o, 1,
1, 0, 0, 0, 0, 0, 1,
